1111111111111111111111
1E000000000000000C0001
1010010100100000010101
1010010010101010010101
1P0000000C00C0000000C1
1010010100100000010101
1010010010101010010101
1001001001010101001001
1101001001010101001001
1000000000000000000001
1111111111111111111111