111111111111111111111111111111
1000001C0011000X010000111001C1
10111001100111000C011000000001
100001000010X01110101100101001
101101C01000000C00001001101X01
10010X101111111111101C10000101
10C100000010C01000101100110001
101100111100001E100C0100100111
1000100100X011111110X1001000C1
101001010101100P10011101101001
10110001010100111C000101X01111
11101011010101X0001001010010C1
110000100001010110101100001001
1100X0101101000100100000100001
10C00000C100010000100111110111
111111111111111111111111111111