1111111111111111111111
1E000000000000000C0001
1011100101000100111001
1010C10101100101000101
1P000100C0010101000001
1011000101000100011101
101010010101000100C101
1010010101001101000101
1010010101000100111101
1000000000000000000001
1111111111111111111111