1111111111111111111111
1111111111111111111111
1111111111111111111111
111100X00000000X001111
1111111111111111111111
1111P000000C00000E1111
1111111111111111111111
111100X00000000X001111
1111111111111111111111
1111111111111111111111
1111111111111111111111