1111111111111111111111
1111111111111111111111
11000000000E1000C00011
110010C010101010010011
1100011100100010111011
1101000000111000100011
11000X00010P01000X0011
1100111010000010111011
11000C00000000000C0011
1111111111111111111111
1111111111111111111111