1111111111111111111111
1000011X000010000000E1
1011000101C01X00111101
101C01010110011000C101
101001000C100110011101
1000110111C01000010001
1010010000100001101001
101X00000X111100001X01
1011101111C00001101101
1P0000000000111C000001
1111111111111111111111